Apple	Apple
アップル	Apple
あっぷる	Apple
APPLE	Apple

Sony	Sony
ソニー	Sony

Panasonic	Panasonic
パナソニック	Panasonic

Sharp	Sharp
シャープ	Sharp

Toshiba	Toshiba
東芝	Toshiba
Dynabook	Dynabook
ダイナブック	Dynabook

Hitachi	Hitachi
日立	Hitachi

Mitsubishi Electric	Mitsubishi Electric
三菱電機	Mitsubishi Electric

Fujitsu	Fujitsu
富士通	Fujitsu
NEC	NEC
日本電気	NEC
VAIO	VAIO
バイオ	VAIO

Dell	Dell
デル	Dell
HP	HP
ヒューレットパッカード	HP
Lenovo	Lenovo
レノボ	Lenovo
ASUS	ASUS
エイスース	ASUS
アスース	ASUS
Acer	Acer
エイサー	Acer
MSI	MSI
Razer	Razer
Microsoft	Microsoft
マイクロソフト	Microsoft
Google	Google
グーグル	Google
Amazon	Amazon
アマゾン	Amazon
Meta	Meta
Facebook	Meta
フェイスブック	Meta

Canon	Canon
キヤノン	Canon
Nikon	Nikon
ニコン	Nikon
Epson	Epson
エプソン	Epson
Ricoh	Ricoh
リコー	Ricoh
Olympus	Olympus
オリンパス	Olympus
OM SYSTEM	OM SYSTEM

Dyson	Dyson
ダイソン	Dyson
Philips	Philips
フィリップス	Philips
Braun	Braun
Bosch	Bosch
ボッシュ	Bosch

Daikin	Daikin
ダイキン	Daikin
Iris Ohyama	Iris Ohyama
アイリスオーヤマ	Iris Ohyama
Zojirushi	Zojirushi
象印	Zojirushi
Tiger	Tiger
タイガー魔法瓶	Tiger
T-fal	T-fal
ティファール	T-fal
Thermos	Thermos
サーモス	Thermos
KitchenAid	KitchenAid
Le Creuset	Le Creuset
ルクルーゼ	Le Creuset
Staub	Staub
ストウブ	Staub
HARIO	HARIO
ハリオ	HARIO

MUJI	MUJI
無印良品	MUJI
UNIQLO	UNIQLO
ユニクロ	UNIQLO
GU	GU
ジーユー	GU
ZARA	ZARA
H&M	H&M

Nike	Nike
ナイキ	Nike
Adidas	Adidas
アディダス	Adidas
PUMA	PUMA
プーマ	PUMA
New Balance	New Balance
ニューバランス	New Balance
ASICS	ASICS
アシックス	ASICS
The North Face	The North Face
ノースフェイス	The North Face

Louis Vuitton	Louis Vuitton
ルイヴィトン	Louis Vuitton
LV	Louis Vuitton
Gucci	Gucci
グッチ	Gucci
Prada	Prada
プラダ	Prada
Chanel	Chanel
シャネル	Chanel
Hermès	Hermès
エルメス	Hermès
Dior	Dior
ディオール	Dior
YSL	Saint Laurent
サンローラン	Saint Laurent
Coach	Coach
コーチ	Coach
PORTER	PORTER
ポーター	PORTER
吉田カバン	PORTER

Tiffany & Co.	Tiffany & Co.
ティファニー	Tiffany & Co.
Cartier	Cartier
カルティエ	Cartier
Bvlgari	Bvlgari
ブルガリ	Bvlgari
Swarovski	Swarovski
スワロフスキー	Swarovski
MIKIMOTO	MIKIMOTO
ミキモト	MIKIMOTO

Rolex	Rolex
ロレックス	Rolex
Omega	Omega
オメガ	Omega
Seiko	Seiko
セイコー	Seiko
Grand Seiko	Grand Seiko
グランドセイコー	Grand Seiko
Citizen	Citizen
シチズン	Citizen
Casio	Casio
カシオ	Casio
G-SHOCK	Casio
TAG Heuer	TAG Heuer
タグホイヤー	TAG Heuer
IWC	IWC
Breitling	Breitling
ブライトリング	Breitling

Nintendo	Nintendo
任天堂	Nintendo
PlayStation	PlayStation
PS	PlayStation
Xbox	Xbox
SEGA	SEGA
セガ	SEGA
Square Enix	Square Enix
スクウェアエニックス	Square Enix
Capcom	Capcom
カプコン	Capcom
Bandai Namco	Bandai Namco
バンダイナムコ	Bandai Namco
Konami	Konami
コナミ	Konami

LEGO	LEGO
レゴ	LEGO
Takara Tomy	Takara Tomy
タカラトミー	Takara Tomy
Bandai	Bandai
バンダイ	Bandai

IKEA	IKEA
イケア	IKEA
NITORI	NITORI
ニトリ	NITORI
Herman Miller	Herman Miller
ハーマンミラー	Herman Miller

Kodansha	Kodansha
講談社	Kodansha
Shueisha	Shueisha
集英社	Shueisha
Shogakukan	Shogakukan
小学館	Shogakukan
KADOKAWA	KADOKAWA
角川	KADOKAWA

Fujifilm	Fujifilm
富士フイルム	Fujifilm
FUJIFILM	Fujifilm

Leica	Leica
ライカ	Leica

Sigma	Sigma
シグマ	Sigma

Tamron	Tamron
タムロン	Tamron

GoPro	GoPro
ゴープロ	GoPro

DJI	DJI
ディージェーアイ	DJI

Coleman	Coleman
コールマン	Coleman

Snow Peak	Snow Peak
スノーピーク	Snow Peak

Montbell	Montbell
モンベル	Montbell

Helinox	Helinox
ヘリノックス	Helinox

SK-II	SK-II
SK2	SK-II
エスケーツー	SK-II

Kanebo	Kanebo
カネボウ	Kanebo

POLA	POLA
ポーラ	POLA

Estée Lauder	Estée Lauder
Estee Lauder	Estée Lauder
エスティローダー	Estée Lauder

Clinique	Clinique
クリニーク	Clinique

Francfranc	Francfranc
フランフラン	Francfranc

ACTUS	ACTUS
アクタス	ACTUS

Pigeon	Pigeon
ピジョン	Pigeon

Combi	Combi
コンビ	Combi

Aprica	Aprica
アップリカ	Aprica

Richell	Richell
リッチェル	Richell

Pampers	Pampers
パンパース	Pampers

Merries	Merries
メリーズ	Merries

Under Armour	Under Armour
アンダーアーマー	Under Armour

Mizuno	Mizuno
ミズノ	Mizuno

Yonex	Yonex
ヨネックス	Yonex

Wilson	Wilson
ウィルソン	Wilson

Callaway	Callaway
キャロウェイ	Callaway

Titleist	Titleist
タイトリスト	Titleist

TaylorMade	TaylorMade
テーラーメイド	TaylorMade

Specialized	Specialized
スペシャライズド	Specialized

Trek	Trek
トレック	Trek

Giant	Giant
ジャイアント	Giant

 Starbucks     Starbucks
 スターバックス    Starbucks